11111111111111111111111111111111111111111111111111111111111111111111111111111111111111111111111
11111111111111111111111111111111111111111111111111111111111111111111111111111111111111111111111
11111111111111111111111111111111111111111111111111111111111111111111111111111111111111111111111
11111111111111111111111111111111111111111111111111111111111111111111111111111111111111111111111
11111111111111111111111111111111111111111111111111111111111111111111111111111111111111111111111
11111000000000000000222222222200000000000000000000000000000000000222222222200000000000000011111
11111000000000000000222222222200000000000000000000000000000000000222222222200000000000000011111
11111000000000000000222222222200000000000000000000000000000000000222222222200000000000000011111
11111000000000000000222222222200000000000000000000000000000000000222222222200000000000000011111
11111000000000000000222222222200000000000000000000000000000000000222222222200000000000000011111
11111000002222222222222222222222222222222222200000222222222222222222222222222222222220000011111
11111000002222222222222222222222222222222222200000222222222222222222222222222222222220000011111
11111000002222222222222222222222222222222222200000222222222222222222222222222222222220000011111
11111000002222222222222222222222222222222222200000222222222222222222222222222222222220000011111
11111000002222222222222222222222222222222222200000222222222222222222222222222222222220000011111
11111000002222200000000002222200000000000000000000000000000000000222220000000000000000000011111
11111000002222200000000002222200000000000000000000000000000000000222220000000000000000000011111
11111000002222200000000002222200000000000000000000000000000000000222220000000000000000000011111
11111000002222200000000002222200000000000000000000000000000000000222220000000000000000000011111
11111000002222200000000002222200000000000000000000000000000000000222220000000000000000000011111
11111000000000000000000002222200000000000000000000000000000000000222220000000000000000000011111
11111000000000000000000002222200000000000000000000000000000000000222220000000000000000000011111
11111000000000000000000002222200000000000000000000000000000000000222220000000000000000000011111
11111000000000000000000002222200000000000000000000000000000000000222220000000000000000000011111
11111000000000000000000002222200000000000000000000000000000000000222220000000000000000000011111
11111222222222222222000002222200000111112222211111222221111100000000000000022222222222222211111
11111222222222222222000002222200000111112222211111222221111100000000000000022222222222222211111
11111222222222222222000002222200000111112222211111222221111100000000000000022222222222222211111
11111222222222222222000002222200000111112222211111222221111100000000000000022222222222222211111
11111222222222222222000002222200000111112222211111222221111100000000000000022222222222222211111
11111222222222222222000000000000000222220000022222000002222200000000000000022222222222222211111
11111222222222222222000000000000000222220000022222000002222200000000000000022222222222222211111
11111222222222222222000000000000000222220000022222000002222200000000000000022222222222222211111
11111222222222222222000000000000000222220000022222000002222200000000000000022222222222222211111
11111222222222222222000000000000000222220000022222000002222200000000000000022222222222222211111
11111000002222222222000000000000000111112222211111222221111100000000000000022222222220000011111
11111000002222222222000000000000000111112222211111222221111100000000000000022222222220000011111
11111000002222222222000000000000000111112222211111222221111100000000000000022222222220000011111
11111000002222222222000000000000000111112222211111222221111100000000000000022222222220000011111
11111000002222222222000000000000000111112222211111222221111100000000000000022222222220000011111
11111222222222222222000000000000000222220000022222000002222200000000000000022222222222222211111
11111222222222222222000000000000000222220000022222000002222200000000000000022222222222222211111
11111222222222222222000000000000000222220000022222000002222200000000000000022222222222222211111
11111222222222222222000000000000000222220000022222000002222200000000000000022222222222222211111
11111222222222222222000000000000000222220000022222000002222200000000000000022222222222222211111
11111222222222222222000000000000000111112222211111222221111100000222220000022222222222222211111
11111222222222222222000000000000000111112222211111222221111100000222220000022222222222222211111
11111222222222222222000000000000000111112222211111222221111100000222220000022222222222222211111
11111222222222222222000000000000000111112222211111222221111100000222220000022222222222222211111
11111222222222222222000000000000000111112222211111222221111100000222220000022222222222222211111
11111000000000000000000002222200000000000000000000000000000000000222220000000000000000000011111
11111000000000000000000002222200000000000000000000000000000000000222220000000000000000000011111
11111000000000000000000002222200000000000000000000000000000000000222220000000000000000000011111
11111000000000000000000002222200000000000000000000000000000000000222220000000000000000000011111
11111000000000000000000002222200000000000000000000000000000000000222220000000000000000000011111
11111000000000000000000002222200000000000000000000000000000000000222220000000000222220000011111
11111000000000000000000002222200000000000000000000000000000000000222220000000000222220000011111
11111000000000000000000002222200000000000000000000000000000000000222220000000000222220000011111
11111000000000000000000002222200000000000000000000000000000000000222220000000000222220000011111
11111000000000000000000002222200000000000000000000000000000000000222220000000000222220000011111
11111000002222222222222222222222222222222222200000222222222222222222222222222222222220000011111
11111000002222222222222222222222222222222222200000222222222222222222222222222222222220000011111
11111000002222222222222222222222222222222222200000222222222222222222222222222222222220000011111
11111000002222222222222222222222222222222222200000222222222222222222222222222222222220000011111
11111000002222222222222222222222222222222222200000222222222222222222222222222222222220000011111
11111000000000000000222222222200000000000000000000000000000000000222222222200000000000000011111
11111000000000000000222222222200000000000000000000000000000000000222222222200000000000000011111
11111000000000000000222222222200000000000000000000000000000000000222222222200000000000000011111
11111000000000000000222222222200000000000000000000000000000000000222222222200000000000000011111
11111000000000000000222222222200000000000000000000000000000000000222222222200000000000000011111
11111111111111111111111111111111111111111111111111111111111111111111111111111111111111111111111
11111111111111111111111111111111111111111111111111111111111111111111111111111111111111111111111
11111111111111111111111111111111111111111111111111111111111111111111111111111111111111111111111
11111111111111111111111111111111111111111111111111111111111111111111111111111111111111111111111
11111111111111111111111111111111111111111111111111111111111111111111111111111111111111111111111
