11111111111111111111111111111111111
11111111111111111111111111111111111
11111111111111111111111111111111111
11111111111111111111111111111111111
11111111111111111111111111111111111
11111000000000000000000000000011111
11111000000000000000000000000011111
11111000000000000000000000000011111
11111000000000000000000000000011111
11111000000000000000000000000011111
11111000000000022222000000000011111
11111000000000022222000000000011111
11111000000000022222000000000011111
11111000000000022222000000000011111
11111000000000022222000000000011111
11111000002222222222222220000011111
11111000002222222222222220000011111
11111000002222222222222220000011111
11111000002222222222222220000011111
11111000002222222222222220000011111
11111000000000022222000000000011111
11111000000000022222000000000011111
11111000000000022222000000000011111
11111000000000022222000000000011111
11111000000000022222000000000011111
11111000000000000000000000000011111
11111000000000000000000000000011111
11111000000000000000000000000011111
11111000000000000000000000000011111
11111000000000000000000000000011111
11111111111111111111111111111111111
11111111111111111111111111111111111
11111111111111111111111111111111111
11111111111111111111111111111111111
11111111111111111111111111111111111